1111111111111
1000010000001
10000C1000C01
100001E100001
1000000000001
1000011100001
1P00100000001
10010001C1001
1000000000001
1C00001001001
1111111111111
