1111111111111
1C000100000C1
1000000000001
1P0001E000001
1000000000001
1000000000001
1000100000001
100E0001C1001
100C000000001
1000001001001
1111111111111
